0,0,0,0,0,0,0,0,0,0,0,0,0,0,1,1,0,0,0,0,0,0,0,0,0,0,0,0,0,0,0,0
0,0,0,0,0,0,0,0,0,0,0,0,0,0,1,1,0,0,0,0,0,0,0,0,0,0,0,0,0,0,0,0
0,0,0,0,0,0,0,0,0,0,0,0,0,1,1,1,1,0,0,0,0,0,0,0,0,0,0,0,0,0,0,0
0,3,1,1,0,1,1,1,0,3,1,1,0,3,1,0,1,0,1,1,1,0,1,1,3,0,1,1,3,0,0,0
0,1,1,1,2,1,7,1,2,1,1,1,2,1,1,1,1,2,1,1,1,2,1,1,1,0,1,5,1,0,0,0
0,1,1,1,0,4,1,1,0,1,1,1,0,1,1,1,3,0,1,1,3,0,1,1,1,0,1,1,1,0,0,0
0,0,0,0,0,0,0,0,0,0,2,0,0,0,0,0,0,0,0,0,0,0,0,0,0,0,2,0,0,0,0,0
0,0,0,0,0,0,0,0,0,0,1,0,0,0,0,0,0,0,0,0,0,0,0,0,0,0,1,0,0,0,0,0
0,0,0,1,3,1,0,0,3,1,1,0,0,1,1,1,1,0,0,3,1,1,0,0,1,3,1,0,0,0,0,0
0,1,2,1,1,1,0,0,1,1,1,1,2,1,1,1,1,0,0,1,1,1,1,2,1,1,1,2,1,1,3,0
0,0,0,1,1,1,0,0,1,1,1,0,0,1,1,1,4,0,0,1,1,1,0,0,1,1,1,0,0,0,0,0
0,0,0,0,1,0,0,0,0,1,0,0,0,0,0,0,0,0,0,0,2,0,0,0,0,2,0,0,0,0,0,0
0,0,0,0,2,0,0,0,0,2,0,0,0,0,0,0,0,0,0,0,1,0,0,0,0,1,0,0,0,0,0,0
0,0,0,1,1,1,0,0,3,1,1,0,0,1,1,1,1,0,0,1,1,1,0,0,3,1,1,0,0,0,0,0
0,4,1,1,1,1,2,1,1,1,1,2,1,1,1,1,1,2,1,1,1,1,0,0,1,7,1,2,1,1,3,0
0,0,0,3,1,1,0,0,1,1,1,0,0,1,6,4,1,0,0,1,1,4,0,0,1,1,1,0,0,0,0,0
0,0,0,0,0,0,0,0,0,0,0,0,0,0,0,0,0,0,0,0,0,0,0,0,0,2,0,0,0,0,0,0
0,0,0,0,0,0,0,0,0,0,0,0,0,0,0,0,0,0,0,0,0,0,0,0,0,1,0,0,0,0,0,0
0,0,0,1,3,1,0,0,3,1,1,0,0,1,1,1,1,0,0,1,3,1,0,0,1,1,1,0,0,0,0,0
0,1,2,1,5,1,1,2,1,1,1,1,2,1,1,1,1,1,2,1,1,1,2,1,1,1,1,2,1,1,3,0
0,0,0,1,1,1,0,0,1,1,1,0,0,1,1,4,1,0,0,1,1,1,0,0,1,4,1,0,0,0,2,0
0,0,0,0,0,0,0,0,0,2,0,0,0,0,0,0,0,0,0,0,0,0,0,0,0,0,0,0,0,0,1,0
0,0,0,0,0,0,0,0,0,1,0,0,0,0,0,0,0,0,0,0,0,0,0,0,0,0,0,0,0,0,1,0
0,0,0,1,1,1,0,0,1,1,1,0,0,1,1,1,1,0,0,1,1,3,0,0,1,1,1,0,0,0,1,0
0,1,2,1,1,1,1,2,1,0,1,1,2,1,1,1,1,2,1,1,1,1,2,1,1,0,1,2,1,1,1,0
0,1,0,1,4,1,0,0,1,1,1,0,0,1,1,4,1,0,0,1,6,1,0,0,1,1,1,0,0,0,0,0
0,1,0,0,0,0,0,0,0,2,0,0,0,0,0,0,0,0,0,0,0,0,0,0,0,1,0,0,0,0,0,0
0,1,0,0,0,0,0,0,0,1,0,0,0,0,0,0,0,0,0,0,0,0,0,0,0,2,0,0,0,0,0,0
0,1,0,1,1,1,0,0,1,1,1,0,0,3,1,3,0,0,0,1,1,1,0,0,1,1,1,0,0,0,0,0
0,1,2,1,1,1,1,2,1,7,1,0,0,1,8,7,1,1,2,1,1,1,1,1,1,0,1,2,1,1,3,0
0,0,0,1,1,3,0,0,1,1,1,0,0,3,1,3,0,0,0,4,1,1,0,0,1,1,1,0,0,0,0,0
0,0,0,0,0,0,0,0,0,0,0,0,0,0,0,0,0,0,0,0,0,0,0,0,0,0,0,0,0,0,0,0
